000000000000000000000000000000
000000000000000000000000000000
000000000000000000000000000000
000000333333300000000000000000
000000000000000000000000000000
000000000000000000000000000000
220000000000000002200000022000
112222222222222221100002211200
111111111111111111100001111100
111111111111111111100000110000
111111111111111111100000100000
111111111111111111100000100000
111111111111111111100000000000